##########################################################
####..E......###..#.....#.E..###..F......###..........E..#
####.#.#####.......#######.#..##.#.#####.....#########.#.#
#.E.E#...#########.#..F..#..#.F.E#...#####.###....F..#..##
#.##########...###.#.###.##.#.##########.#.###.#.###.##.##
#...####.###.#.#...#...#....#...####.###.#.....#...#....##
###.##...#...#.###.#.##########.##.........###.#.#########
###.#..#.#.###...#.#...F..#######..#.#.###...#.###.F..####
#I....##.#....##.#...##.#...E.....##.#....##.#......#...##
#.##..#..#.##.##.####...#.....##..#..#.##.##.####...###.##
#.######.##......#..#####.....######.##...#..#..#######.##
#.FFF..#...##.####...#..F.....#....#.#.##.####...#..F....#
######.##.........#.##.###########.##.....#...#.########.#
#.#....##########......####...#....##.#######......####..#
#...##.##.#.....#.##.#.#...#....##..#.#.#.....##.#.#.....#
#.#####...#.#.######.#####.##.#####...#.#.######.#####.###
#.#....#....#..##...#.#.##....#....#..#....##...#.#.##...#
#...##.#.#.###....#.....####F...##.#.#.###....#.....#...F#
###..E...#...##.###.###......##..E...#...##.###.###.....P#
##########################################################